50 50 15 15
50 50
0 0 0 0 0 0 0 0 0 0 0 0 0 0 0
0 2 1 2 1 2 1 2 1 2 1 2 1 2 0
0 1 2 1 2 1 2 1 2 1 2 1 2 1 0
0 2 1 2 1 2 1 2 1 2 1 2 1 2 0
0 1 2 1 2 1 2 1 2 1 2 1 2 1 0
0 2 1 2 1 2 1 2 1 2 1 2 1 2 0
0 1 2 1 2 1 2 1 2 1 2 1 2 1 0
0 2 1 2 1 2 1 2 1 2 1 2 1 2 0
0 1 2 1 2 1 2 1 2 1 2 1 2 1 0
0 2 1 2 1 2 1 2 1 2 1 2 1 2 0
0 1 2 1 2 1 2 1 2 1 2 1 2 1 0
0 2 1 2 1 2 1 2 1 2 1 2 1 2 0
0 1 2 1 2 1 2 1 2 1 2 1 2 1 0
0 2 1 2 1 2 1 2 1 2 1 2 1 2 0
0 0 0 0 0 0 0 0 0 0 0 0 0 0 0