50 50 20 20
900 50
0 0 0 0 0 0 0 0 0 0 0 0 0 0 0 0 0 0 0 0
0 2 1 2 1 2 1 2 1 2 1 2 1 2 1 2 1 2 1 0
0 1 2 1 2 1 2 1 2 1 2 1 2 1 2 1 2 1 2 0
0 2 1 2 1 2 1 2 1 2 1 2 1 2 1 2 1 2 1 0
0 1 2 1 2 1 2 1 2 1 2 1 2 1 2 1 2 1 2 0
0 2 1 2 1 2 1 2 1 2 1 2 1 2 1 2 1 2 1 0
0 1 2 1 2 1 2 1 2 1 2 1 2 1 2 1 2 1 2 0
0 2 1 2 1 2 1 2 1 2 1 2 1 2 1 2 1 2 1 0
0 1 2 1 2 1 2 1 2 1 2 1 2 1 2 1 2 1 2 0
0 2 1 2 1 2 1 2 1 2 1 2 1 2 1 2 1 2 1 0
0 1 2 1 2 1 2 1 2 1 2 1 2 1 2 1 2 1 2 0
0 2 1 2 1 2 1 2 1 2 1 2 1 2 1 2 1 2 1 0
0 1 2 1 2 1 2 1 2 1 2 1 2 1 2 1 2 1 2 0
0 2 1 2 1 2 1 2 1 2 1 2 1 2 1 2 1 2 1 0
0 1 2 1 2 1 2 1 2 1 2 1 2 1 2 1 2 1 2 0
0 2 1 2 1 2 1 2 1 2 1 2 1 2 1 2 1 2 1 0
0 1 2 1 2 1 2 1 2 1 2 1 2 1 2 1 2 1 2 0
0 2 1 2 1 2 1 2 1 2 1 2 1 2 1 2 1 2 1 0
0 1 2 1 2 1 2 1 2 1 2 1 2 1 2 1 2 1 2 0
0 0 0 0 0 0 0 0 0 0 0 0 0 0 0 0 0 0 0 0